===================Parse Table========================
| - - - - - - 0 - - - - - - - - 0 - - - - - - - - - - - - - - - - - - - - - - - - - - - - - - - - - - - - - - - - - - - - - |
| - - - - - - - - - - - - - - - 0 - - - - - - - - - - - - - - - - - - - - - - - - - - - - - - - - - - - - - - - - - - - - - |
| - - - - - - 0 - - - - - - - - 1 - - - - - - - - - - - - - - - - - - - - - - - - - - - - - - - - - - - - - - - - - - 1 - - |
| - - - - - - 0 - - - - - - - - - - - - - - - - - - - - - - - - - - - - - - - - - - - - - - - - - - - - - - - - - - - - - - |
| - - - - - - - - - - - - - - - - - - - - - 0 - - - - - - - - - - - - - - - - - - - - - - - - - - - - - - - - - - - - - - - |
| - - - - - - - - - - - - - - - - - - - - - - 0 1 - - - - - - - - - - - - - - - - - - - - - - - - - - - - - - - - - - 1 - - |
| - - - - - - - 0 - - - - 0 0 - - - - - - - - - - - - - - - - - - - - - - - - - - - 0 - - - - - - - - - - - 0 - - - - - - - |
| - - - - - - - 1 - - - - 0 0 - - - - - - - - - - - - - - - - - - - - - - - - - - - 1 - - - - - - - - - - - 1 - - - - - - - |
| - - - - - - - - - - - - 0 1 - - - - - - - - - - - - - - - - - - - - - - - - - - - - - - - - - - - - - - - - - - - - - - - |
| - - - - - - - 2 - - - - - - - - - - - - - - - - - - - - - - - - - - - - - - - - - 0 - - - - - - - - - - - 1 - - - - - - - |
| - - - - - - - - - - - - - - - - - - - - 1 - - - - - 0 - - - - - - - - - - - - - - - - - - - - - - - - - - - - - - - 1 - - |
| - - - 0 - - - - - - - 0 - - 0 - - - - 0 - - - - - - - - - - 0 - - 0 0 0 - - - - 0 0 - - - - - - - - - - - 0 - 0 - - - - - |
| - - - 1 - - - - - - - 1 - - 1 - - - - 1 - - - - - - - - - - 1 - - 1 1 1 - - - - 1 0 - - - - - - - - - - - 0 - 0 - - 1 - - |
| - - - - - - - - - - - - - - - - - - - - - - - - - - - - - - - - - - - - - - - - - 0 - - - - - - - - - - - 0 - 1 - - - - - |
| - - - - - - - - - - - - - - - - - - - - - - - - - - - - - - - - - - - - - - - - - 0 - - - - - - - - - - - 1 - - - - - - - |
| - - - - - - - - - - - - - - - - - - - - - - - - - - - - - - - - - - - - - - - - - - - - - - - - - - - - - - - 0 - - - - - |
| - - - - - - - - - - - - - - - - - - - - - - - - - - - - - - - - - - - - - - - - - 0 - - - - - - - - - - - 1 - - - - - - - |
| - - - - - - - - - - - - - - 0 - - - - - - - - - - - - - - - - - - - - - - - - - - - - - - - - - - - - - - - - - - - - - - |
| - - - - - - - - - - - - - - 0 - - - - - - - - - - - - - - - - - - - - - - - - - - - - - - - - - - - - - - - - - - - - - - |
| - - - - - - - 1 - - - - 0 0 - - - - - - - - - - - - - - - - - - - - - - - - - - - - - - - - - - - - - - - - - - - - - - - |
| - - - - - - - - - - - - - - 0 - - - - - - - - - - - - - - - - - - - - - - - - - - - 1 - - - - - - - - - - - 1 - - - 1 - - |
| - - - 1 - - - - - - - 1 - - 0 - - - - 1 - - - - - - - - - - 1 - - 1 1 1 - - - - 1 - - - - - - - - - - - - - - - - - 1 - - |
| - - - - - - - - - - - - - - 0 - - - - - - - - - - - - - - - - - - - - - - - - - - - - - - - - - - - - - - - - - - - - - - |
| - - - - - - - - - - - - - - - - - - - - - - - 1 0 - - - - - - - - - - - - - - - - - - - - - - - - - - - - - - - - - 1 - - |
| - - - 0 - - - - - - - 0 - - - - - - - 0 - - - - - - - 1 - - 0 - 1 0 0 1 - - - - 0 - - 1 - - - - - - - - - - - - - - 1 - - |
| - - - 0 - - - - - - - 1 - - - - - - - 4 - - - - - - - - - - 2 - - 3 3 - - - - - 4 - - - - - - - - - - - - - - - - - - - - |
| - - - 0 - - - - - - - - - - - - - - - - - - - - - - - - - - - - - - - - - - - - - - - - - - - - - - - - - - - - - - - - - |
| - - - 0 - - - - - - - - - - - - - - - - - - - - - - - - - - - - - - - - - - - - - - - - - - - - - - - - - - - - - - - - - |
| 1 - - - - - - - - - - - - - - - - - - - - - - 1 - 0 - - - 1 - - - - - - 1 1 1 1 - - - - - - - 1 1 1 1 1 1 - - - - - 1 - - |
| - - - - - - - - - - - - - - - - - - - - - - - - - 0 - - - - - - - - - - - - - - - - - - - - - - - - - - - - - - - - - - - |
| 1 - - - - - - - - - - - - - - - - - - - - - - 1 - 0 - - - 1 - - - - - - 1 1 1 1 - - - - - - - 1 1 1 1 1 1 - - - - - 1 - - |
| - - - - - - - - - - - - - - - - - - - 0 - - - - - - - - - - - - - - - - - - - - 0 - - - - - - - - - - - - - - - - - - - - |
| - - - - - - - - - - - - - - - - - - - 0 - - - - - - - - - - - - - - - - - - - - 1 - - - - - - - - - - - - - - - - - 1 - - |
| - - - - - - - - - - - - - - - - - - - 0 - - - - - - - - - - - - - - - - - - - - - - - - - - - - - - - - - - - - - - - - - |
| - - - - - - - - - - - 0 - - - - - - - - - - - - - - - - - - - - - - - - - - - - - - - - - - - - - - - - - - - - - - - - - |
| - - - - - - - - - - - - - - - - - - - - - - - - - - - - - - 0 - - - - - - - - - - - - - - - - - - - - - - - - - - - - - - |
| - - - - - - - - - - - - - - - - - - - - - - - - - - - - - - - - 1 - - - - - - - - - - 0 - - - - - - - - - - - - - - - - - |
| - - - - - - - - - - - - - - - - - - - - - - - - - - - - - - - - - 0 1 - - - - - - - - - - - - - - - - - - - - - - - - - - |
| - - - 0 0 0 - - - - - - - - - - - - - - - - - - - - - - 0 - - - - - - - - - - - - - - - - - - - - - - - - - - - - - - - - |
| - - - - - - - - - - - - - - - - - - - - - - - 1 - - - - - 1 - - - - - - 0 0 - - - - - - - - - - - - - - - - - - - - 1 - - |
| - - - 0 0 0 - - - - - - - - - - - - - - - - - - - - - - 0 - - - - - - - - - - - - - - - - - - - - - - - - - - - - - - - - |
| - - - - - - - - - - - - - - - - - - - - - - - 1 - - - - - 1 - - - - - - 1 1 0 0 - - - - - - - - - - - - - - - - - - 1 - - |
| - - - 1 1 1 - - - - - - - - - - - - - - - - - - - - - - 0 - - - - - - - - - - - - - - - - - - - - - - - - - - - - - - - - |
| - - - - - - - - - - - - - - - - - - - - - - - - - - - - - - - - - - - - - - 0 1 - - - - - - - - - - - - - - - - - - - - - |
| - - - - - - - - - - - - - - - - - - - - - - - - - - - - - - - - - - - - 0 1 - - - - - - - - - - - - - - - - - - - - - - - |
| - - - 1 1 1 - - - - - - - - - - - - - - - - - - - - - - 0 - - - - - - - - - - - - - - - - - 2 - - - - - - - - - - - - - - |
| - - - 0 1 2 - - - - - - - - - - - - - - - - - - - - - - - - - - - - - - - - - - - - - - - - - - - - - - - - - - - - - - - |
| - - - - - - - - - - - - - - - - - - - - - - - - - - - - - - - - - - - - - - - - - - - - 0 1 - - - - - - - - - - - - - - - |
| - - - - - - - - - - - - - - - - - - - - - - - - - - - - - - - - - - - - - - - - - - - - - - - 0 1 2 3 4 5 - - - - - - - - |
| - - - - - - - - - - - - - - - - - - - - - - - - - - - - - - - - - - - 0 - - - - - - - - - - - - - - - - - - - - - - - - - |
| - - - - - - - - - - - - - - - - - - - 0 - - - 1 - - - - - - - - - - - - - - - - - - - - - - - - - - - - - - - - - - 1 - - |
| - - - 0 - - - - - - - - - - - - - - - - - - - - - - - - - - - - - - - - - - - - - - - - - - - - - - - - - - - - - - - - - |
| - - - - - - - - - - - - - - - - - - - - 1 - - - - - 0 - - - - - - - - - - - - - - - - - - - - - - - - - - - - - - - 1 - - |

======================================================